##################  
#                ## 
# $#   $ ##  $    # 
#    $###    # $$ # 
#.###     $ $ ##  ##
#...#  #  #    #$  #
#..##$$#### $  #   #
#...#      $ ##  ###
#...$  ###  #    # #
##..  $#  ##   ##@ #
 ##.#              #
  ##################