####################
#     #  #...#@    #
# #       ....#    #
#  $  #   #....#   #
# ##$#### ##....#  #
# $   $  #  #...#  #
# $$ #   #   # $$  #
###  $$$#   $$  $  #
# $  #  #    # $#  #
#   $#  #       $  #
#  #    #    #  #  #
####################