    ######
 ####    #
 #    ## #
 # $     #
### #### ########
#  $   $ ##  ...#
#   $$ $$    ...#
#    $  $##  ...#
##@## ## ##  ...#
 ###  $  ########
 #   $$  #
 #    #  #
 #########