####################
#    ##   #    #   #
#  $  $     ## $   #
## #####  .###### ##
 # ##  ##....#### ##
## ##$ ###..##     #
#      #... .# $ $ #
# $ ## ## . ### ####
# # $    #.## # #
# $ $ #   .#### ##
# #  ## # ##  #  ##
#######  $##$   $ #
      ##      $ #@#
       #  ## ######
       #######