  #################
###@##         ...#
#    #         ...#
# $  #         ...#
# $$ #         ...#
## $ ###$##########
 # ###  $ #
##   $  $ #
#  $ #  $ #
# $  #    #
#  $ #    #
#    #    #
###########