####################
#     ###..###     #
# $$  ###..###  $@ #
#  # ##......#  $  #
#     #......#  $  #
####  ###..######$ #
#   $$$ #..#    #  #
# $#   $  $  $$ #$ #
#  #  ## $  ##  #  #
# $    $ ## $    $ #
#  #  ##    ##  #  #
####################