####################
#####@###.##...##  #
#####$  ..#...#    #
####    ......#  $ #
###  $ #.....## # ##
##  $$# #####  $ $ #
## $# $    ##  $$  #
##  #  #    # $  $ #
##   $$ ### #$##   #
## $#      $ $  $ ##
###    #    #    ###
####################