####################
#   #  #@# ##  #####
# # #  $    $  #####
# #    ###### $  ###
#   #  #....#  $$  #
##$##$##....#      #
#      #....##$##$##
#  $$  #....#      #
# $  $  #  #  ###  #
#####  $   $    $  #
##### #    #  #   ##
####################