####################
#....#       #  #  #
#....# # $  $      #
#.... ##  $# # $#$ #
#...#   $   $#  $  #
#..####  # $   $$  #
#      #### #### ###
#        #   #     #
# ##   #   $ # $ $ #
# ##    $ ## $  $  #
#     @#     #   # #
####################