####################
#     #   #####    #
## $  #   ####  $  #
#### $$   #..#  #  #
#  $  $  ##..#### ##
# $   ###....   $$ #
#  #$#   ....# # $ #
# #  # $ ..###$#   #
# #   $ #..#   ##  #
#   $#  ####   # $##
# #  #    @#      ##
####################