#############
#           #
# ### $$    #
#   # $  $  #
#  $####$######
# $ ##        #####
#  $$ $        ...#
### ## $$#     ...#
  # ##   #     ...#
  #      #     ...#
  ###@#############
    ###