####################
# # # #   #@##   # #
#             $    #
#  ##$# ##### $ # ##
##    ##.....#  #  #
##$##$#.....###$#$ #
#   # ##.....#  # ##
#  $    ##..##  #  #
# $ #   $   $  $$$ #
## $  $# #  #  $   #
#   ##   #  #      #
####################