############
#      #   ##
# $  $   #  ######
####  #####      #
 #..  #     #### #
 #.####  ####    #
 #....    #  $ ####
 # ...#   # $$$#  ##
###.#### ##  $@$   #
#     ##### $ #    #
# #.# $      $###$ #
# #.########  #  $ #
# #..        ##  $ #
# # ####### $ # #  #
#   #     #       ##
#####     ##########