####################
#  #      #   #   ##
# $# $ $ ##...$  $ #
#  $  # ##....# $  #
# ## $ ##....#   $ #
# $    #....## $   #
# $##  #...#       #
#   $$$##$##  ### ##
# # #  #   #  #    #
# $ #  $  ##       #
#    #    #@       #
####################