 #########
 #       #
 # $ $$ $#
### #  $ #
#.#   $$ ##
#.###   $ #
#.#. $ ## ####
#...  $## $  #
#...$   $    #
#..###$### #@#
#..# #     ###
#### #######