#############
#........####
#...#### #  #####
#...#  ###    $ #
#...$$     $ $  #
#  .#  $ $# $  ##
#...# #$#   $  #
#.# # $   $    #
#.  #$###$####$#
##  #   $ $    #
 #  #  $@$  #  #
 #  # #### $  $#
 #  #    ###   #
 #  # $$ # #####
 #  #    #
 #########